обіцянка: основна, стадіонна, стадіонна, основна, стадіонна, сказана, ключова, основна, невиконана
Володимир: озвучений
рік: 2019
річниця: друга
дебат: стадіонний
тур: другі, другі
організація: громадська, добровольча
реформ: медичні
прогрес: певний
скасування: часткове
недоторканність: депутатська, депутатська
рішення: косметичне, мирне
результат: необхідний
крок: революційний
система: політична, медична
статус: існуючий
сфера: основна
заява: озвучена
країна: найбідніша
президент: найбагатший, жорсткий
спад: економічний, економічний
р.: 2020, 2020, 2020, 2020, 2020, 2021, 2021
ВВП: реальний
виробництво: промислове
господарство: сільське
ліки: якісні
ціна: доступна
умова: нормальна
зарплата: нормальна
реформа: нафа, медична
проблема: визначена, найбільша
будівництво: велике
значення: державне
рада: верховний
корупція: політична
депутат: народний
група: промислова
справа: None
провадження: кримінальне
свинарчук: гладковська
дія: важлива
політика: український
посадок: гучні, корупційні
влада: попередній
шлях: дипломатичний
втрата: бойова
армія: українська
поранений: вбитий
агресія: російська, російська
газеть: None
питання: першочергове
